F 20,       20,20
C 200,200,200

NO        srcs/assets/textures/north.xpm
SO srcs/assets/textures/south.xpm
EA srcs/assets/textures/east.xpm
WE srcs/assets/textures/west.xpm

11111111111111111111111
10000000000000000000001
10000001100000000011001
10000000000000000000001
11100000100001110000001
10000001100010001000001
10000010100000010000111
10000100100000100000001
10001111110011111000001
10000000100000000000001
10000000000000000011001
10011000000000000000001
1000000000011000000N001
11111111111111111111111
