NO        srcs/assets/textures/north.xpm
SO srcs/assets/textures/south.xpm
EA srcs/assets/textures/east.xpm
WE srcs/assets/textures/west.xpm


F 20,       20,20





C 200,200,200


1111111
1000001
1N00001
1001001
1000001
1111111