11111111111111111111111
10000000000000000000001
10000000000000000011001
10000000000000000000001
10000000000000000000001
10000000000000000000001
10000000000000000000111
10000000000000000000001
10000000000000000000001
10000000000000000000001
10000000000000000011001
10011000000000000000001
1000000000011000000N001
11111111111111111111111