F 0,       0,255
C 200,200,200

NO        srcs/assets/textures/block.xpm
SO srcs/assets/textures/south.xpm
EA srcs/assets/textures/east.xpm
WE srcs/assets/textures/west.xpm

1111111111111111111111111111111
1000000000000000000000000000001
1000000000000000000000000000001
1000111100000010000111101110001
1001000000000010000000101001001
1001000001001011100011101001001
1001000001001010000000101001001
1000111101111011101111101110001
1000000000000000000000000000001
100000000000000000N000000000001
1111111111111111111111111111111
