F 0,       0,255
C 200,200,200

NO        srcs/assets/textures/north.xpm



SO srcs/assets/textures/south.xpm
EA srcs/assets/textures/east.xpm
WE srcs/assets/textures/west.xpm
       11111111111111111111111111111111    
111111110000000000000000000000000000001
100000000000000000000000000000111111111
1110111100000010000111101111101
1001000000000010000000111111111
1111000001001011100011101  1101
1001000001001010001000101  1001
1000111101111011110111101110001
1000000000000000000000000000001
10000000000000000W0000000000001
1111111111111111111111111111111    