
NO        srcs/assets/textures/north.xpm



SO srcs/assets/textures/south.xpm
EA srcs/assets/textures/east.xpm
WE srcs/assets/textures/west.xpm


F 220,100,0
C 225,30,0


        1111111111111111111111111
    11111000000110000000000001
    1011000001110000000000001
    100100000000000000000000111111111
111111111011000001110000000000001
1111100000011000001110111110111111
    11110111111111111100000010001
11110111111111 111010100100011111
11000000110101111100000010001
10000000000000001100000010001
100W0000000000001101010010001
1100000111010101111101111000111
11110111 1110101 101111010001
11111111 1111111 111111111111