NO assets/textures/north.xpm
SO assets/textures/south.xpm
EA assets/textures/east.xpm
WE assets/textures/west.xpm

F 220,100,0    # Floor color (R,G,B)
C 135,206,235  # Ceiling color (R,G,B)

1111111111111111
1N00000000000001
1000000000000001
1111111111111111