NO srcs/assets/textures/north.xpm
SO srcs/assets/textures/south.xpm
EA srcs/assets/textures/east.xpm
WE srcs/assets/textures/west.xpm
F 20,20,20
C 200,200,200

1111
1001
1111