F 20,       20,20





C 200,200,200



NO        srcs/assets/textures/north.xpm
SO srcs/assets/textures/south.xpm
EA srcs/assets/textures/east.xpm
WE srcs/assets/textures/west.xpm






11111111111111111111111111111
11110111111111011101010010001
1100000011010101110000001001
10000000000000001100000010001
10000000000000001101010010001
11000001110101011111011110N01
11110111011101011101111010001
11111111111111111111111111111