F 20,       20,20
C 200,200,200

NO        srcs/assets/textures/north.xpm
SO srcs/assets/textures/south.xpm
EA srcs/assets/textures/east.xpm
WE srcs/assets/textures/west.xpm

11111111111111111
10000000000000001
10111000000000001
100S0000000000001
10000000000000001
1000000000S000001
10000000000000001
10000001110000001
10000000000000001
11111111111111111
